15 21
"W W         W       W"
"WWWWWWWWWWWWWWWWWWWWW"
"W W WWWWWWW WWWWW W W"
"W   W   W W   WK  W W"
"WWWWW W W WWW W WWWWW"
"WbG   W     W W     W"
"WWW WWWWWWW W WWWWW W"
"W   W   Wy        W W"
"WRWWW W WWWWWWW W W W"
"W W   W         W   W"
"W W WWWWWWWWWWW WWWWW"
"W W       WrY W W  gW"
"W WWWWWWW WWW W W WWW"
"WP     B      W     W"
"WWWWWWWWWWWWWWWWWWWWW"